1;
Hello!;
3;
50;
 ; ; ; ; ; ; ; ; ; ; ; ; ; ; ; ; ; ; ; ; ; ; ; ; ; ; ; ; ; ; ; ; ; ; ; ; ; ; ; ; ; ; ; ; ; ; ; ; ; ;
 ; ; ; ; ; ;4; ; ; ; ; ; ; ; ; ; ; ; ; ; ; ; ; ;7; ; ; ; ; ; ; ; ; ; ; ; ; ; ; ; ; ; ; ; ; ; ; ; ; ;
 ; ; ; ; ;2;2; ; ; ; ; ;7; ; ; ; ; ; ; ; ; ; ; ;2;2;2; ; ; ; ; ; ; ; ; ; ; ; ; ; ; ; ; ; ; ; ; ; ; ;
 ; ; ; ; ; ; ; ; ;2;2;2;2; ; ; ; ; ; ; ; ; ; ; ; ; ; ; ; ; ; ; ; ; ; ; ; ; ; ; ; ; ; ; ; ; ; ; ; ; ;
 ; ; ; ; ; ; ; ; ; ; ; ; ; ; ; ; ; ; ; ; ; ; ; ; ; ; ; ; ; ; ; ; ; ; ;4; ; ; ; ; ;6; ; ; ; ; ; ; ; ;
 ; ; ; ;2;2;2;2; ; ; ; ; ; ; ; ;2;2;2;2; ; ; ; ; ; ; ; ; ; ; ; ; ;2;2;2; ; ;2;2;2;2;2; ; ; ; ; ; ; ;
 ; ; ; ; ; ; ; ; ; ; ; ; ; ; ; ; ; ; ; ; ; ; ; ; ; ; ; ; ; ; ; ; ; ; ; ; ; ; ; ; ; ; ; ; ; ;9; ;8; ;
 ; ; ; ; ; ; ; ; ; ; ; ; ;2;2;2; ; ; ; ; ; ; ; ;2;2;2; ; ;2;2;2; ; ; ; ; ; ; ; ; ; ; ; ; ; ;2;2;2; ;
 ; ; ; ; ;2;2;2;2;2; ; ; ; ; ; ; ; ; ; ; ; ; ; ; ; ; ; ; ; ; ; ; ; ; ;2;2;2; ; ; ; ; ; ; ;5; ; ; ; ;
 ; ; ; ; ; ; ; ; ; ; ; ; ; ; ; ; ; ; ;2;2;2;2; ; ; ; ; ; ; ; ; ; ; ; ; ; ; ; ; ; ; ; ; ;2;2;2; ; ; ;
 ; ; ; ; ; ; ; ; ; ; ; ; ; ; ; ; ; ; ; ; ; ; ; ; ; ; ; ; ; ; ; ; ; ; ; ; ; ; ; ; ; ; ; ; ; ; ; ; ; ;
 ; ; ; ; ; ; ;2;2;2;2;2;2; ; ; ; ; ; ; ; ; ; ;2;2;2; ; ; ; ; ; ; ;2;2; ; ; ; ; ; ;2;2; ; ; ; ; ; ; ;
 ; ; ; ; ; ; ; ; ; ; ; ; ; ; ; ; ; ; ; ; ; ; ; ; ; ; ; ; ; ; ; ; ; ; ; ;5; ; ; ; ; ; ; ; ; ; ; ; ; ;
 ; ; ; ;2;2;2;2; ; ; ; ; ; ; ; ; ; ; ; ;2;2;2; ; ; ; ; ; ; ; ; ; ; ; ; ;2;2;2; ; ; ; ; ; ; ; ; ; ; ;
 ; ; ; ; ; ; ; ; ; ; ; ; ; ; ; ; ; ; ; ; ; ; ; ; ; ; ; ; ; ; ; ; ; ; ; ; ; ; ; ; ; ; ; ; ; ; ; ; ; ;
 ; ; ; ; ; ; ; ; ; ; ; ; ; ; ; ; ;6; ; ; ; ; ; ; ; ; ; ; ; ; ; ; ; ; ; ; ; ; ; ; ; ; ; ; ; ; ;6; ; ;
1;1;1;1;1;1;1;1;3;3;3;3;1;1;1;1;1;1;1;1;1;1;1;1;1;1;1;3;3;1;1;1;1;1;1;1;1;1;1;1;1;1;1;1;3;3;1;1;1;1;